3 5

w w w w w
w f f f w
w w w w w

. . . . .
. p . e .
. . . . .