9 8

w w w . . . . .
w f w w . . . .
w f f w w . . .
w w f f w w . .
. w w f f w w .
. . w w f f w w
. . . w w f f w
. . . . w w f w
. . . . . w w w

. . . . . . . .
. p . . . . . .
. . . . . . . .
. . . . . . . .
. . . . . . . .
. . . . . . . .
. . . . . . . .
. . . . . . e .
. . . . . . . .